A	AH
A(2)	EY
ALSO	AO L S OW
BOT	B AA T
CAR	K AA R
COT	K AA T
DRIVE	D R AY V
FORGET	F ER G EH T
FORGET(2)	F AO R G EH T
HERE	HH IY R
HOP	HH AA P
IS	IH Z
LOOP	L UW P
NOT	N AA T
PASTA	P AA S T AH
REMEMBER	R IH M EH M B ER
REMEMBER(2)	R IY M EH M B ER
ROT	R AA T
TOY	T OY
VAN	V AE N
WORD	W ER D
YOU	Y UW
